Tipodecamas,Basicas,Media,UTI,UCI,Total,Aumento%
15-04-2020 ,384 ,157 ,111 ,384 ,1036 ,
16-04-2020 ,385 ,113 ,168 ,407 ,1073 ,4% 
17-04-2020 ,360 ,131 ,180 ,380 ,1051 ,-2% 
18-04-2020 ,407 ,195 ,134 ,373 ,1109 ,6% 
19-04-2020 ,424 ,204 ,129 ,377 ,1134 ,2% 
20-04-2020 ,428 ,202 ,121 ,392 ,1143 ,1% 
21-04-2020 ,422 ,219 ,184 ,399 ,1224 ,7% 
22-04-2020 ,470 ,192 ,120 ,411 ,1193 ,-3% 
23-04-2020 ,489 ,189 ,118 ,415 ,1211 ,2% 
24-04-2020 ,494 ,193 ,125 ,418 ,1230 ,2% 
